SSSUUUUUUUUUUUUUUUUU
SSSUUUUUUUUUUUUUUUOU
SSSUUUUUUUUUUUUUUUUU
UUUUOUUUUOOOOOOUUUUU
UUUUOUUUUUUUUUUUUUUU
OUUUOUUUUUUUUUUUOUUU
UUUUUUUUUUUUUUUUUUUU
UUUUUUUUUUUUUUUUUUUU
UUUUUUUUUUUUUUUUUUUU
UUUOUUUUUUUUUUUOUUUO
UUUUUUUUUUUUUUUOUUUU
UUUUUOOOOOOUUUUOUUUU
UUUUUUUUUUUUUUUUUEEE
UOUUUUUUUUUUUUUUUEEE
UUUUUUUUUUUUUUUUUEEE