SSSUUUUUUUOUUUUUUUUU
SSSUUUUUUUOUUUUUUUUU
SSSUUUUUUUOUUUUUUUUU
UUUUUUUUUUUUUUUUUUUU
UUUUUUUUUUUUUUUUUUUU
UUUUUUUUUUUUUUUUUUUU
UUUUUUUUUUUUUUUUUUUU
OOUUUUUUUUUUUUUUUUUU
UUUUUUUUUOUUUUUUUUUU
UUUUUUUUUUUUUUUOUUUU
UUUUUUUUUUUUUUUOUUUU
UUUUUUUUUUUOUUUOUUUU
UUUUUUUUUUUUUUUUUEEE
UUUUUUUUUUUUUUUUUEEE
UUUUUUUUUUUUUUUUUEEE