SSSUUUUUUUUUUUUUUUUU
SSSUUUUUOUUUUUUUUUUU
SSSUUUUUOUUUUUUUUUUU
UUUUUUUUOUUUUUUUUOUU
UUUUUUUUUUUUUUUUUOUU
UUUOOUUUUUUUUOUUUOUU
UUUOOUUUUUUUUOUUUUUU
UUUUUUUOUUUUUOUUUUUU
UUUUUUUOOOOUUUUUUUUU
UUUUUUUUUUUUUUUUUUUU
UUUUUUUUUUUUUUUUUUUU
OOOUUUUUUUUUUUUUUUUU
UUUUUUOOUUUUUOOUUEEE
UUUUUUUOUUUUUUOUUEEE
UUUUUUUOUUUUUUOUUEEE