SSSUUUUUUUOUUUUOUUUU
SSSUUUUUUUOUUUUOUUUU
SSSUUUUUUUOUUUUOUUUU
UUUUUUUUUOOUUUUOOUUU
UUUUUUUUUUUUUUUUUUUU
UUUUUUUUUUUUUUUUUUUU
OUUUUOUUUUUUUUUUUUUU
OUUUUOUUUUWUUUUUUUUO
OUUUUOUUUUUUOOOUUUUU
UUUUOOUUUUUUOOOUUUUU
UUUUUUUUUUUUUUUUUUUU
UUUUUUUUUUUUUUUUUUUU
UUUUUUUUUUUUUUUUUEEE
UUUUUUUUUUUUUUOUUEEE
UUUUUOOOUUUUUUOUUEEE