SSSUUUUUUUUUUUUUUUUU
SSSUWUUUUUUUUUUUOUUU
SSSUUUUUUUUUUUUUOUUU
OOUUUUUUUUOUOOUUUUUU
UUUUUUUUUUUUUUUUUUUU
UOUUUUUUUUUUUUUUUUUU
UUUUUUUUUUUUUUUUOUUU
UUUUUUUUUUUUUUUUUUUU
UUUUUUUUUUUUUUUUUUUU
UUUOUUUUUUUUUUUUUUUU
UUUUUUUUUUUUOUUUUUOU
UUUUUUUUUUUUUUUUUOUU
UUUUUOOUUUUUUUUUUEEE
UUUUUOUUUUUUUUUUUEEE
UUUUOUUUUUUUUUUUUEEE